NO ./resources/textures/wall2.xpm
SO ./resources/textures/wall2.xpm
WE ./resources/textures/wall1.xpm














EA ./resources/textures/wall1.xpm

C 135,206,235






F 86,125,70

1111111111111111111111111111111111111111111111111111111111111111111111111111111111111111111111111
1000000000000000000000000000000000000000000000000000000000000000000000000000000000000000000000001
1000000000000000000000000000000000000000000000000000R00000000000000000000000000000000000000000001
1000000000000000000000000000000000000000000000000000000000000000000000000000000000000000000000001
1000000000000000000000011111111000011111111111111000000001111000000011110000111111100011111000001
1000000000000000000001111111000000011100001111111000000001101000000010110000111111110011111000001
1000000000000000001111111100000000010000001111111000000001101000000010110000111111111011111000001
1000000000000000111111100000000000000001111111100000000001101111111110110000111111111111111000001
100000000000011111111000000000000000011111111000000E000002000000000000020000111111111111111000001
1000000000001111111111111111111110011111111000001000000001101111111110110000111110111111111000001
1000000000001111111111111111111110011111111000111000000001101000000010110000111110011111111000001
1000000000001111111111111111111110011111111111111000000001101000000010110000111110001111111000001
1000000000000000000000000111111110000000000000000000000001111000000011110000111110000111111000001
1000000000000000000000000111111110000000000000000000000000000000000000000000000000000000000000001
100000000000000000000000000000000000000000000000000G000000000000000000000000000000000000000000001
1000000000000000000000000000000000000000000000000000000000000000000000000000000000000000000000001
1111111111111111111111111111111111111111111111111111111111111111111111111111111111111111111111111