NO ./resources/textures/wall.xpm
SO ./resources/textures/wall.xpm
WE ./resources/textures/wall.xpm
EA ./resources/textures/wall.xpm





F 228,109    ,      101
C 228,109    ,      101



1111111111111111111111111
1000000000000G00000000001
1000000000000000000000001
10000R0000000000000G00001
1000000000000000000000001
1000000000000000000000001
1000000000000000000000001
1000000000000000000000001
1000000000000000000000001
100000000000S000000000001
1000000000000000000000001
1000000000000000000000001
1000000000000000000000001
1111111111111111111111111