NO ./resources/textures/wall.xpm
SO ./resources/textures/floor.xpm
WE ./resources/textures/floor.xpm
EA ./resources/textures/wall.xpm





C 124,252,0

F 124,252,21



111111111
100000001
1000N0001
100000001
100000001
100000001
100000001
111111111
