NO ./resources/textures/wall1.xpm
SO ./resources/textures/wall2.xpm
WE ./resources/textures/wall2.xpm
EA ./resources/textures/wall1.xpm





F 222,109    ,      101
C 228,109    ,      101



1111111111111111111111111
1000000000000G00000000001
1000000000000000000000001
10000R0000000000000G000011
100000000000000000000000001
10000000000000000000000011
1000000000000000000000001
1000000000000000020000001
1000000000000000000000001
1000000000000000000000001
1000000000000000000000001
1000000000000N00000000001
1000000000000000000000001
1111111111111111111111111